,Overall,KM3_1,KM3_2,KM3_3,KM4_1,KM4_2,KM4_3,KM4_4,KM5_1,KM5_2,KM5_3,KM5_4,KM5_5,KM6_1,KM6_2,KM6_3,KM6_4,KM6_5,KM6_6,KM7_1,KM7_2,KM7_3,KM7_4,KM7_5,KM7_6,KM7_7,KM8_1,KM8_2,KM8_3,KM8_4,KM8_5,KM8_6,KM8_7,KM8_8
Seg_size,8950.0,1820.0,1598.0,5532.0,1460.0,3873.0,1230.0,2387.0,1156.0,3517.0,2135.0,1384.0,758.0,3318.0,485.0,2087.0,1236.0,1069.0,755.0,3137.0,480.0,1216.0,1884.0,753.0,734.0,746.0,1154.0,2396.0,510.0,742.0,427.0,1033.0,1805.0,883.0
Seg_Pct,1.0,0.20335195530726258,0.17854748603351955,0.6181005586592179,0.16312849162011173,0.43273743016759775,0.13743016759776536,0.26670391061452514,0.12916201117318435,0.3929608938547486,0.23854748603351955,0.15463687150837988,0.0846927374301676,0.37072625698324024,0.05418994413407821,0.23318435754189945,0.1381005586592179,0.1194413407821229,0.08435754189944134,0.3505027932960894,0.053631284916201116,0.1358659217877095,0.2105027932960894,0.0841340782122905,0.08201117318435754,0.08335195530726257,0.1289385474860335,0.2677094972067039,0.05698324022346369,0.0829050279329609,0.04770949720670391,0.11541899441340782,0.2016759776536313,0.09865921787709497
BALANCE,1452.3995929909956,3785.59309815535,1643.115372652813,629.6996661474569,1708.9885787691076,314.7649401045012,4488.423044173162,1576.878121034352,4611.709645208466,340.9815955244624,1616.6417186880558,1763.036390014592,761.2602938916874,339.6471830491517,4236.7538717669995,1619.6882494274075,827.193827849353,4526.254769818365,762.8265952223828,285.00738745449155,4207.5688096318645,812.7032538320726,1592.563720010086,5261.627124219815,745.0827238513615,2128.340489542026,823.522160015121,204.39641189580547,2711.9120443039174,752.3564248165757,4328.359499921418,865.1936093331067,1530.230131053739,4658.612095630089
BALANCE_FREQUENCY,0.8832520119553052,0.9722804071428568,0.9726597640800992,0.8281353693058541,0.9761494965753413,0.7641419816679577,0.9671647463414629,0.9764527478005859,0.9729333088235291,0.7733011111742958,0.9860762304449637,0.9788059559248544,0.7925519775725589,0.7637295201928868,0.9919233628865977,0.9869364575946326,0.9665242823624581,0.9710508222637976,0.7914627801324499,0.7619091769206245,0.9923758479166664,0.9665119720394724,0.9901177473460715,0.9872922988047806,0.7914455926430515,0.9030073083109905,0.9707550103986125,0.7453900421535895,0.9906912352941175,0.7905323894878704,0.9918340374707258,0.8233995411423038,0.9837773988919659,0.970859633069082
PURCHASES_FREQUENCY,0.4903505483798885,0.3211526587912085,0.9199071408010002,0.42193202422270565,0.9260887191780811,0.492648852310872,0.3141303691056911,0.3109084704650194,0.3181110233564014,0.4955139775376761,0.3173259306791571,0.9294182984104034,0.41473960290237466,0.4716066416515992,0.9229730453608248,0.3169381662673697,0.9094740064724908,0.26079927315247914,0.41304688211920526,0.4901667076825009,0.9258480791666667,0.9090541710526306,0.33941000212314243,0.28659233466135464,0.4186124073569482,0.18586262332439682,0.9208386048526854,0.49758749749582715,0.5268310450980396,0.4132396347708895,0.9292905807962529,0.43533982962245854,0.2692957030470909,0.25579898754246927
ONEOFF_PURCHASES_FREQUENCY,0.20245768357542138,0.10716968461538491,0.6897209299123906,0.09305375921908829,0.7021560678082189,0.10508760495739694,0.12250574878048792,0.09600420779220821,0.12629617474048452,0.1132257665624108,0.09589592599531661,0.7060724017341039,0.11324652110817941,0.08245881766124218,0.5903979360824742,0.09454411164350784,0.6998804652103561,0.09808512254443393,0.11236569536423842,0.08428430793752047,0.597794758333333,0.7007008675986843,0.10094894373673069,0.11106345949535198,0.11308278882833786,0.0694119209115283,0.7216000849220104,0.07177931385642752,0.11915128627450994,0.11200101347708896,0.6303859882903982,0.13396693707647617,0.09047843324099743,0.10479998980747444
PURCHASES_INSTALLMENTS_FREQUENCY,0.3644373415642452,0.23315022967032958,0.630724979349185,0.33070901518438134,0.6468061952054779,0.38946446294861803,0.21972431300812992,0.22568931378299104,0.22305551643598615,0.391144326130224,0.23399546135831373,0.6603760520231199,0.283201410290238,0.3906693661844477,0.7495516329896907,0.2343460996645902,0.5765771399676373,0.1756068746492049,0.28144013774834487,0.4074622684093075,0.7540450687499999,0.5760548338815786,0.25230248832271746,0.19434317928286854,0.2858894550408724,0.12005308042895442,0.5823336031195838,0.42535414148580847,0.43337542549019603,0.2821134460916447,0.7621974238875876,0.31809822458857706,0.18861999889196687,0.16499456172140428
CASH_ADVANCE_FREQUENCY,0.12763742659218116,0.29770251483516386,0.06467206508135163,0.08987534906001404,0.06414314657534244,0.05240827472243752,0.3423590723577225,0.1778915236698779,0.3389226937716256,0.04799801080466319,0.16500669133489457,0.06450576589595373,0.18494203693931388,0.049696305605786736,0.14311506391752593,0.16429406468615237,0.04239541747572818,0.34853443124415295,0.18567690596026482,0.03781694070768244,0.14026557083333346,0.04031036430921054,0.14822021178344005,0.3498900066401073,0.18152809536784734,0.310218058981234,0.04461357798960141,0.04147124332220364,0.12405967647058837,0.18460343261455517,0.14908854098360677,0.06879194869312695,0.17932841440443237,0.37695236693091755
PURCHASES_TRX,12.684022346368716,7.636813186813187,37.23466833541927,7.252711496746204,38.62123287671233,8.467079783113865,7.817886178861789,6.169250104733976,8.131487889273357,9.02189365936878,6.482435597189696,39.53468208092485,5.060686015831134,8.284508740204943,44.7979381443299,6.300431241015812,33.76132686084142,5.310570626753976,4.96953642384106,8.610137073637233,45.24166666666667,33.688322368421055,6.889596602972399,6.043824701195219,5.028610354223433,3.497319034852547,34.81109185441941,8.638146911519199,12.827450980392157,4.963611859838275,46.667447306791566,8.368828654404647,5.086426592797784,5.294450736126841
CREDIT_LIMIT,4366.667327459594,6260.524475524725,6639.142678347935,3087.159803924144,6786.369863013699,3703.718401404948,7865.369549150408,2159.4749336686214,8005.324001258652,3938.8551566272386,2166.84621389555,6860.549132947976,2445.049845360639,3872.180378224533,8232.98969072165,2153.9610285898416,5961.617387466828,7976.477591632368,2450.3944142826017,3730.8557522948677,8291.145833333334,5968.264055023848,2000.0,8454.515272244356,2410.0106032470903,5680.457388903485,5666.551126516464,2512.9662864031716,3366.9607843137255,2417.988925584049,8894.262295081968,7874.575376220717,2107.017543859834,8238.566869144961
PAYMENTS,1479.577413292575,2172.342817503928,2741.7336582653365,887.0686072312835,2855.8715788406525,919.5223368139207,2564.5005898658137,987.4317586284053,2630.5506623047168,980.7518286757054,1012.7031511253889,2943.2368199647426,681.3141364221646,958.9186799139093,3423.8497262558803,990.3797155905131,2462.2558524852343,2598.3679944398987,678.1886961784777,859.3778857700346,3462.489178263753,2455.4994058723255,882.2478600293261,2564.9839548968794,659.6118263157367,2440.6492913569687,2466.863385597919,782.8934517826352,1511.7616934424516,680.3962657072788,3624.2133873649946,1499.5131785529031,963.9374607738508,2726.3295041451283
MINIMUM_PAYMENTS,648.8660726262847,1591.1047259930665,626.7185129030663,345.2719748877063,636.4789946806816,246.8534577993771,1639.6915805810354,798.1600048595934,1694.5173303321521,253.12366230899542,839.6107003497148,654.8377598116183,342.20196698506555,255.29711484632787,1722.2914423354996,836.3128794814303,312.4388051683463,1623.2431193273799,341.931041305536,242.2842887382434,1689.6182482356608,307.71601620729945,860.3662783329238,1953.6512842356353,339.1943033860758,698.5361893809613,315.01494975101934,227.8182843966598,2203.171641868239,332.63765044067344,1618.1126288803675,348.14653339962507,581.9645367600261,1615.5394838197763
PRC_FULL_PAYMENT,0.1537146484916212,0.018376487362637355,0.27165595494367956,0.16417112816341375,0.27452250890410945,0.235610011618901,0.019468361788617876,0.016120478005865115,0.01769591262975778,0.2315420372476551,0.015325553161592499,0.2747136495664739,0.16890836015831137,0.22559508951175464,0.042266449484536076,0.014242499760421645,0.3469937370550162,0.0191527904583723,0.16905917880794705,0.23278780841568422,0.04531089166666666,0.35095645394736846,0.011003961252653913,0.009214358565737048,0.172509295640327,0.057220878016085865,0.3455566325823224,0.23691203046744577,0.02362658627450979,0.17081782075471702,0.051857538641686164,0.1982462410454984,0.01485192576177284,0.01902251528878821
TENURE,11.58413407821229,11.552197802197803,11.848560700876096,11.51825741142444,11.857534246575343,11.506842241156725,11.53089430894309,11.569752827817345,11.71712802768166,11.907307364230878,11.911943793911007,11.915462427745664,8.353562005277045,11.905364677516577,11.894845360824743,11.912314326784859,11.905339805825243,11.71842843779233,8.349668874172185,11.900860694931463,11.904166666666667,11.905427631578947,11.914012738853502,11.711819389110225,8.30517711171662,11.78686327077748,11.909012131715771,11.89941569282137,11.905882352941177,8.335579514824797,11.887587822014051,11.908034849951598,11.90415512465374,11.668176670441676
Monthly_avg_purchase,71.03092942763638,42.448547412508184,222.22764969209808,36.758980093746864,231.33334464965228,44.63021520659183,47.52492336357185,27.93115037977781,48.598000809347816,44.463308151532374,27.432815669576346,236.23127203757252,49.679330762868055,40.09692627449909,265.50317624960775,27.241110467395586,198.31866752534614,31.879518709073924,50.14953696783352,41.36708723833815,269.48684462594514,198.62623905125645,29.35578502380495,35.39880268991376,50.74693783248996,21.26705606500664,200.47230898846743,37.2314141561694,62.4660515522876,49.977312866341514,284.19093209317805,55.782241828986876,21.228432997565665,32.77978219053503
Monthly_cash_advance,73.6365778972795,222.7948446875679,32.4756755051574,36.454198371662464,32.49417917741196,25.10329045853245,277.07376260313225,72.71893533049034,270.70426416239866,23.24073895817983,58.6482563503278,33.06832046736959,123.2123760662387,24.398443272121945,94.85747728397291,56.96019463053858,16.38794170021973,280.21932984316123,123.71069560698939,13.324115745661269,92.06355377612368,14.914695935472112,39.290096279498535,267.21593366743105,119.45892910017503,257.3778171779592,16.8681711692417,17.59321701912216,40.15613133845368,122.97304053767495,99.13990448659692,40.32237587540593,66.9287275898947,318.1318514350292
limit_usage,0.38394485411419293,0.7066990681567065,0.2831444413750732,0.3068780410266542,0.28089175029359653,0.09853638698185631,0.650919323336797,0.7724936298317486,0.6597154431488483,0.09858131452383402,0.7862085397549504,0.2844449983672644,0.3360656975521333,0.09904404856299073,0.598132223698769,0.7905898949322899,0.1812376270406379,0.6459828784824105,0.33517569251986934,0.09210732584374377,0.5883740399402045,0.177511376365655,0.8179527381167635,0.7299796164265308,0.3344687912323827,0.4194298763706883,0.19359207243229948,0.0936417581533975,0.8304786869680529,0.33289650251559677,0.5561945101676788,0.11661623913920777,0.7707843873110605,0.6441186353459298
cluster_3,1.4147486033519554,0.0,1.0,2.0,0.9965753424657534,1.972889233152595,0.008130081300813009,1.4897360703812317,0.007785467128027681,1.9516633494455502,1.4805620608899297,0.9971098265895953,1.646437994722955,1.9912597950572635,0.7814432989690722,1.4916147580258745,1.0679611650485437,0.0,1.6463576158940398,1.9977685686962066,0.8020833333333334,1.0682565789473684,1.526008492569002,0.0,1.6662125340599454,0.82171581769437,1.0623916811091854,2.0,0.27647058823529413,1.6590296495956873,0.8524590163934426,1.7734753146176185,1.7041551246537396,0.0
cluster_4,1.507709497206704,2.312087912087912,0.1520650813516896,1.6346710050614606,0.0,1.0,2.0,3.0,2.0025951557093427,1.0036963321012227,2.9934426229508198,0.000722543352601156,1.658311345646438,1.0274261603375527,0.49690721649484537,2.9923334930522283,0.15453074433656958,2.0140318054256316,1.6622516556291391,1.015938795027096,0.44375,0.14638157894736842,2.9808917197452227,2.0,1.6525885558583107,2.1193029490616624,0.14211438474870017,1.003338898163606,2.588235294117647,1.65633423180593,0.3231850117096019,1.0813165537270086,2.965096952908587,2.0045300113250284
cluster_5,1.6727374301675977,0.8637362637362638,2.8035043804755944,1.6122559652928417,2.945890410958904,1.3408210689388071,0.22845528455284553,2.176790950984499,0.0,1.0,2.0,3.0,4.0,1.0081374321880652,2.3484536082474228,1.9956875898418782,2.6480582524271843,0.03461178671655753,3.989403973509934,1.0111571565189672,2.4,2.651315789473684,1.9915074309978769,0.005312084993359893,3.9931880108991824,0.9865951742627346,2.707105719237435,1.006677796327212,1.4294117647058824,3.9946091644204853,2.5152224824355973,1.058083252662149,1.9706371191135734,0.020385050962627407
cluster_6,1.834413407821229,3.3005494505494504,2.5294117647058822,1.1513015184381779,2.5191780821917806,0.6924864446165763,3.792682926829268,2.2593213238374528,3.7275086505190314,0.19277793574068808,1.989695550351288,2.463872832369942,4.977572559366755,0.0,1.0,2.0,3.0,4.0,5.0,0.014663691424928276,1.0291666666666666,2.997532894736842,2.007430997876858,3.957503320053121,4.998637602179836,2.415549597855228,2.972270363951473,0.018781302170283808,2.3666666666666667,4.979784366576819,1.0562060889929743,0.5333978702807357,1.9512465373961219,3.9830124575311436
cluster_7,2.2035754189944132,4.1461538461538465,1.846683354192741,1.6675704989154012,1.8041095890410959,0.8974954815388587,4.32520325203252,3.4738165060745705,4.27681660899654,0.44668751777082744,3.2894613583138175,1.7413294797687862,4.978891820580475,0.35322483423749246,1.065979381443299,3.2879731672256827,2.01537216828479,4.590271281571562,4.997350993377483,0.0,1.0,2.0,3.0,4.0,5.0,6.0,2.0103986135181975,0.10642737896494157,3.0549019607843135,5.0,1.0210772833723654,1.3707647628267183,3.3202216066481993,4.568516421291053
cluster_8,3.2989944134078213,5.246703296703297,1.3235294117647058,3.2288503253796095,1.2212328767123288,2.1438161631809964,5.896747967479675,5.105571847507331,6.064878892733564,2.06056297981234,5.310538641686183,1.19364161849711,3.005277044854881,2.1353224834237494,3.729896907216495,5.340201245807379,0.3794498381877023,6.306828811973808,3.014569536423841,2.0054191903092127,3.7125,0.36019736842105265,5.252123142250531,6.192563081009296,3.019073569482289,5.684986595174263,0.0,1.0,2.0,3.0,4.0,5.0,6.0,7.0
